NO ./srcs/sssr.xpm
WE ./srcs/checklist.xpm

SO ./srcs/ne-dushi.xpm

EA ./srcs/you.xpm

S ./srcs/leni n.xpm

F 35 , 155, 127

C 200, 200 , 255
R 1920 1080

1111111111
11000000111
10E000000001
11010000111
12020000211
111111111

