NO ./srcs/sssr.xpm
WE ./srcs/checklist.xpm

SO      ./srcs/ne-dushi.xpm

EA ./srcs/you.xpm

S ./srcs/leni n.xpm

F 35 , 155, 127

C 200, 200 , 255
R 1920 1080

11111   
110111
100001
120211
12S211
120211
120211
120211
120211
120211
120211
120211
120211
120211
120211
120211
120211
120211
120211
120211
120211
120211
120211
120211
120211
120211
120211
120211
120211
120211
120211
120211
120211
120211
120211
120211
120211
120211
120211
120211
120211
120211
120211
120211
120211
120211
120211
120211
120211
120211
120211
120211
120211
120211
120211
120211
120211
120211
120211
120211
120211
120211
120211
120211
120211
120211
120211
120211
120211
120211
120211
120211
120211
120211
120211
120211
120211
120211
120211
120211
120211
120211
120211
120211
120211
120211
120211
120211
120211
120211
120211
120211
120211
120211
120211
120211
120211
120211
120211
120211
120211
120211
120211
120211
120211
120211
120211
120211
120211
120211
120211
120211
120211
120211
120211
120211
120211
120211
120211
120211
120211
120211
120211
120211
120211
120211
120211
120211
120211
120211
120211
120211
120211
120211
120211
120211
120211
120211
120211
120211
120211
120211
120211
120211
120211
120211
120211
120211
120211
120211
120211
120211
120211
120211
120211
120211
120211
120211
120211
120211
120211
120211
120211
120211
120211
120211
120211
120211
120211
120211
120211
120211
120211
120211
120211
120211
120211
120211
120211
120211
120211
120211
120211
120211
120211
120211
120211
120211
120211
120211
120211
120211
120211
120211
120211
120211
120211
120211
120211
120211
120211
120211
120211
120211
120211
120211
120211
120211
120211
120211
120211
120211
120211
120211
120211
120211
120211
120211
120211
120211
120211
120211
120211
120211
120211
120211
120211
120211
120211
120211
120211
120211
120211
120211
120211
120211
120211
120211
120211
120211
120211
120211
120211
120211
120211
120211
120211
120211
120211
120211
120211
120211
120211
120211
120211
120211
120211
120211
120211
120211
120211
120211
120211
120211
120211
120211
120211
120211
120211
120211
120211
120211
120211
120211
120211
120211
120211
120211
120211
120211
120211
120211
120211
120211
120211
120211
120211
120211
120211
120211
120211
120211
120211
120211
120211
120211
120211
120211
120211
120211
120211
120211
120211
120211
120211
120211
120211
120211
120211
120211
120211
120211
120211
120211
120211
120211
120211
120211
120211
120211
120211
120211
120211
120211
120211
120211
120211
120211
120211
120211
120211
120211
120211
120211
120211
120211
120211
120211
120211
120211
120211
120211
120211
120211
120211
120211
120211
120211
120211
120211
120211
120211
120211
120211
120211
120211
120211
120211
120211
120211
120211
120211
120211
120211
120211
120211
120211
120211
120211
120211
120211
120211
120211
120211
120211
120211
120211
120211
120211
120211
120211
120211
120211
120211
120211
120211
120211
120211
120211
120211
120211
120211
120211
120211
120211
120211
120211
120211
120211
120211
120211
120211
120211
120211
120211
120211
120211
120211
120211
120211
120211
120211
120211
120211
120211
120211
11111

