NO ./srcs/n.xpm
EA ./srcs/e.xpm
WE ./srcs/w.xpm
SO ./srcs/s.xpm

C 250,30,0
F 250,100,0 


        1111111111111111111111111
        1000000000110000000000001
        1011000001110000000000001
        10010E0000000000000000001
111111111011000001110000000000001
100000000011000001110111011111111
11111101111111111111111101111
11111101111111111111111101111
11111001111111111111111001111    
11110001111111011101010010001
110000001111111100000010001111111111111111111
1000000000111111100000000000000000000000000001
10000000011111101101010010001111111111111111111
11000001110101011111011110000000000000000000001
11110111111101011101111010001111111111111111111
1111111111111111111111111111





